2222222222
2000022222
2030020442
2003010442
2000020442
2232322322
2000022002
2030000002
2002000002
2222222222
